MMMMMMMMMMMMMMMMMMMMMMMMMMMMMMMMMMMMMMM
M                                     M
M     A                               M
M     AAAAAA            B             M
M       AAA                           M
M     AAAAA                           M
M                                     M
M                                     M
M    R          MMMMMMMMMMMMMMMMMMMMMMM
M                      MM             M
M                     MM     D        M
M          MMMMMMMMMMMMMMMMMMMMMMMMMMMM
M                                     M
M        E                            M
M                           T         M
M                                     M
M                   E                 M
M                                     M
M                                     M
M          AAAAA                      M
M         AAAAAAAA          P         M
M          AAAA                       M
MMMMMMMMMMMMMMMMMMMMMMMMMMMMMMMMMMMMMMM