B:5, D:2, T:1, P:1
MMMMMMMMMMMMMMMMMMMMMMMMMMMMMMMMMMMMMMM
M                                     M
M     A                               M
M     AAAAAA             E            M
M       AAA                           M
M     AAAAA                           M
M                                     M
M                                     M
M    R          SSSSSSSSSSSSSSSSSSSSSSM
M                      SS             M
M                    SSS              M
M          SSSSSSSSSSSSSSSSSSSSSSSSSSSM
M                                     M
M         E                           M
M                                     M
M                                     M
M                                     M
M                          E          M
M                                     M
M          AAAAA                      M
M         AAAAAAAA                    M
M          AAAA                       M
MMMMMMMMMMMMMMMMMMMMMMMMMMMMMMMMMMMMMMM