MMMMMMMMMMMMMMMMMMMMMMMMMMMMMMMMMMMMMMM
M                                     M
M     A                               M
M     AAAAAA                          M
M       AAA                           M
M     AAAAA                           M
M                                     M
M                                     M
M    R          MMMMMMMMMMMMMMMMMMMMMMM
M                      MM             M
M                     MM              M
M          MMMMMMMMMMMMMMMMMMMMMMMMMMMM
M                                     M
M        E                            M
M                                     M
M                                     M
M                   E                 M
M                                     M
M                                     M
M                                     M
M                                     M
M                                     M
MMMMMMMMMMMMMMMMMMMMMMMMMMMMMMMMMMMMMMM